NO textures/simonkraft/soul_sand.xpm
SO textures/simonkraft/soul_soil_01.xpm
WE textures/simonkraft/soul_soil.xpm
EA textures/simonkraft/soul_sand.xpm

C 53,41,34
F 45,33,27

111111111111111
111111000111111
111110000011111
1111000N0001111
111000000000111
1100000V0000011
100001111100001
110000111000011
1110V0010000111
1111000V0001111
111110000011111
111111000111111
111111111111111

