11111
1DDD1
1DPD1
1DDD1
11111
