11111
11011
1P011
11111
11111
