NO textures/test/north.xpm
SO textures/test/south.xpm  
WE textures/test/west.xpm
EA textures/test/east.xpm

F 220,100,0
C 225,30,0

        1111111111111111111111111
        1000000000110000000000001
        1011000001110000000000001
        1001000000000000000000001
111111111011000001110000000000001
100000000011H00001110111100111111
11110111111111011100000010001
11110111111111011101010010001
11000000110101V11100000010001
10000000000000001100000010001
10000000000000001101010010001
11000001110101001111011110001
11110111111101011111011110001
11111111111111011111011110001
1111111111111N111111111111111
