   NO textures/wolfenstein/purple_stone.xpm
SO textures/wolfenstein/red_brick.xpm
WE textures/wolfenstein/grey_stone.xpm
EA textures/wolfenstein/wood.xpm

F 17,38,64
C 218,234,235

1111111111111111111111111
1000110000H00000000000001
1000110000000S00111111001
1000110000000000110001001
100000000010000V000001001
1111111111111111111111111
