NO textures/test/north.xpm
SO textures/test/south.xpm
WE textures/test/west.xpm
EA textures/test/east.xpm
F 220,100,0
C 225,30,0

1111111
1000001
10S0001
1000001
1110111
